##############################
#..........####..........#####
#..........#..#..........#..##
#..........#..#..........#..##
#..........####..........#####
#............................#
#####..........####..........#
##..#.............#..........#
##..#..........#..#..........#
#####..........##.#..........#
#............................#
#..........##.#..........#####
#..........#..#..........#..##
#..........O..#.............##
#..........####..........#####
#............................#
#####..........##.#..........#
##..#..........#..#..........#
##..#..........#..#..........#
#####..........#O##..........#
#............................#
#..........####..........#####
#..........#..#..........#..##
#..........#..#..........#..##
#..........####..........#####
#............................#
#............................#
#............................#
#............................#
##############################