##############################
#......#............#........#
#.####.#.##########.#.######.#
#.#....#.#........#.#.....##.#
#.#.####.#.######.#.######.#.#
#.#......#.......#.#.....#.#.#
#.########.####.#.######.#.#.#
#..........#....#........#.#.#
####.############.########.#.#
#....#..........#........#.#.#
#.####.########.########.#.#.#
#.#..............#......#.#..#
#.#.############.#.####.#.#..#
#.#............#.#....#.#.#..#
#.############.#.###..#.#.#..#
#............#.#......#.#.#..#
##########.###.########.#.#..#
#..........#..........#.#.#..#
#.###################.#.#.#..#
#.....................#.#.#..#
#.#######################.#..#
#.........................#..#
#.#.#######################..#
#.#.......................#..#
#.#.#####################.#..#
#.#.......................#..#
#.#.#####################.#..#
#............................#
#............................#
##############################
