##############################
#............O...............#
#..........#####.............#
#..........#...#.............#
#..#####...#...#....#####....#
#..#...#...#####....#...#....#
#..#...#............#...#....#
#..#####............#####....#
#.......O..........O.........#
#.....####........####.......#
#.....#..#........#..#.......#
#.....#..##########..#.......#
#.....#............#.#.......#
#.....##############.#.......#
#....................#.......#
###.##################.#####.#
#....................#.......#
#.....##############.#.......#
#.....#............#.#.......#
#.....#..##########..#.......#
#.....#..#........#..#.......#
#.....####........####.......#
#............................#
#..#####............#####....#
#..#...#............#...#....#
#..#...#...#####....#...#....#
#..#####...#...#....#####....#
#..........#...#.............#
#..........#####.............#
##############################